+...............................+...............................+...............................+...............................+...............................+...............................+...............................+...............................+
|XXXXXXXXXXXXXXXXXXXXXXXXXXXXXXXXXXXXXXXXXXXXXXXXXXXXXXXXXXXXXXXXXXXXXXXXXXXXXXXXXXXXXXXXXXXXXXXXXXXXXXXXXXXXXXXXXXXXXXXXXXXXXXXXXXXXXXXXXXXXXXXXXXXXXXXXXXXXXXXXXXXXXXXX..XXXXXXXXXX..XXXXXXXXXXXXXXXXXXXXXXXXXXXXXXXXXXXXXXXXXXXXXXXXXXXXXXXXXXXXXXXXXXXXXXXXXX
|XXXXXXXXXXXXXXXXXXXXXXXXXXXXXXXXX..............................XX........XX...............XX...XX.........XXXXXXXXXXXX.........................................XX.XXXX...XXXXXXXXXXXX...XXXXXXXXXX.......XX..................................X.................X
|XXXXXXXXXXXXXXXXXXXXXXXXXXXXXXXXX..............................XX........XX...............XX...XX.........XXXXXXXXXXXX........................X................XX.......XXXXXXXXXXXXXXX........XXX.......XX..................................X.................X
|XXXXXXXXXXXXXXXXXXXXXXXXXXXXXXXXX..............................XX...XX...XX...XXXXXXXXXX..XX...XX.........XXXXXXXXXXXX............XX.XX....XX.X.XX....XX.XX.XX.XX......XXXXXXXXXXXXXXX.........XXX...XX..XX....XXXXXXXXXXXXXXXXXXXXXXXXXX....X...XXXXXXXXX.....X
|X..............................XX...................................XX...XX...X................XX.........XXXXXXXXXXXX............XX.XX...X..XXX..X...XX.XX.XX.XX.......XXXXXXXXXXXXXX.........XXX...XX........XX...........X................X...XXX...........X
|X..............................XX...................................XX...XX...X................XX.........XXXXXXXXXXXX.....................XX.X.XX.............XX...........XXXXXX.............XXX...XX........XX...........X................X...XXX...........X
|X..............................XX......XX..............XX...........XX........X.......XXXXXXXXXXX........XXXXXXXXXXXXXX.......................X................XX...........XXXXXX.............XXX...XXXXXX....XX......XX...XXXXXXXXXX.....XXX...XXX...XXX.....X
|X..............................XX..............................XXXXXXXXXXXXXXXXXXXX............XX.......XXXXXXXXXXXXXXXX..........XX.XX.XX.........XX.XX.XX.XX.XX..........X......X............XXX...XXX...............XX............X.....XXX...XXX...XXX.....X
|X..............................XX..............................XX..............................XX......XXXXXXXXXXXXXXXXXX.........XX.XX.XX.........XX.XX.XX.XX.XX..............................XXX....XX...............XX............X.....XXX...XXX...XXX.....X
|X..............................XX..............................XX..............................XX.....XXXXXXXXXXXXXXXXXXXXX....................................XX..............................XXX....XX...XXXXXXXXX...XX............X.....XXX...XXX...XXX.....X
+XXXXXXXXXXXXXX....XXXXXXXXXXXXXXXXXXXXXXXXXXXXXXXXXXXXXXXXXXXXXXXXXXXXXXXXXXXX....XXXXXXXXXXXXXXX......XXXXXXXXXXXXXXXXXX......................................XX..............................XXX....XX...XXXXXXXXX...XX.....XXXX...X.....XXX...XXX...XXX.....X
|XXXXXXXXXXXXXX....XXXXXXXXXXXXXXXXXXXXXXXXXXXXXXXXXXXXXXXXXXXXXXXXXXXXXXXXXXXX....XXXXXXXXXXXXXXX........XXXXXXXXXXXXXX........................................XXXXXXXXXXXXXXX...XXXXXXXXXXXXXXXXXX...XX...XXXXXXXXX...XX.....XXXX...XXX...XXX...XXX...XXX.....X
|XXXXXXXXXXXXXX....XXXXXXXXXXXXXXXXXXXXXXXXXXXXXXXXX.........................XX.................XX........XXXXXXXXXXXXXX........................................XX..............................XXXX...XX...XXXXXXXXX...XX............XXX...XXX...XXX...XXX.....X
|XXXXXXXXXXXXXX....XXXXXXXXXXXXXXXXXXXXXXXXX..................................XX................XX.........XXXXXXXXXXXX.........................................XX..............................XXXX...XX...............XX............XXX.......................X
|XXXX.....................XXXXXXXXXXXXXXXX....................XXXXXX...........XX.....XX........XX.........XXXXXXXXXXXX............XX.XX.XX.XX...XX.XX.XX.XX.XX.XX..............................XXXX...XX...............XX............XXX.......................X
|XX........................XXXXXXXXXXXXX.....XXXXXXXXXXXXXXXXXXXXXXXXXXXXXX.....XX...XX........XXX.........XXXXXXXXXXXX............XX.XX.XX.XX...XX.XX.XX.XX.XX.XX..............................XXXX...XXXXXXXXXXXXXX...XXXXXXXXXXXXXXXXXXXXXXXXXXXXXXXXXXXX....X
|XX.................................XX......XXX.....................................XX.......XXXXX.........XXXXXXXXXXXX.........................................XX..............................XXXX.................................XXX........................X
|X..........................................XX.....................................XX......XXXX............XXXXXXXXXXXX.........................................XX..............................XXXX.................................XXX........................X
|X.....................................XXXXXX......XXXX....XXXXXXXXXXXXXXXXXXXXXXXXX.....XXXX..............XXXXXXXXXXXX............XX.XX.XX.XX...XX.XX.XX.XX.XX.XX..............................XXXXXXXXXXXXXXXXXXXXXXXXXXXXXXXXXXX..XXX....XXXXXXXXXXXXXXXXXXXXX
|XXXXX..................XXXXXXXXXXX...XXX........XXXXXXX..............................XXXXXX...............XXXXXXXXXXXX............XX.XX.XX.XX...XX.XX.XX.XX.XX.XX...................................................................XXX....X...................X
|XXXXXXX..............XXXXXXXXXXXXXXXXXX.......XXXXXXXXXX............................XXXX..................XXXXXXXXXXXX.........................................XX...................................................................XXX....X...................X
+XXXXXXXXXXXXXXXXXXXXXXXXXXXXXXXXXXXXXX.......XXXXXXXXXXXX....XXXXXXXXXXXXXXXXXXXXXXXXXX...................XXXXXXXXXXXX.........................................XXXXXXXXXXXXXXXXXXXXXXXXXXXXXXXXXXXXXXXXXXXXXXXXXXXXXXXXXXXXXXXXXXXXXXXX....XXXXXXXXXXXXXXX.....X
|XXXXXXXXXXXXXXXXXXXXXXXXXXXXXXXXXXXXXX.......XXXXXXXXXXXX....XXXXXXXXXXXXXXXXXXXXXXXXXX...................XXXXXXXXXXXX.........................................XXXXXXXXXXXXXXXXXXXXXXXXXXXXXXXXXXXXXXXXXXXXXXXXXXXXXXXXXXXXXXXXXXXXXXXX...XXXXXXXXXXXXXXXX.....X
|X..............................XXXXXXXXX.......XXXXXXXX.......XXXXXXXXXXXXXXXXXXXXX.......................XXXXXXXXXXXX..............X.X.X.....XX.XX.XX.....X.X.X....X.X.X......X.XX.X......X.X.XXXXXXXXXX...XXX...XXXXXXXXXXXXXXXXXXXXX...XXXXXXXXXXXXXXXX.....X
|X..............................XXXXXXXXXXX..........XX....................................................XXXXXXXXXXXXX.............XXXXX.....XXXXXXXX.....XXXXX....XXXXX......XXXXXX......XXXXXXXXXXXX.............XXXXXXXXXXXXXXXXXXX....XXXXXXXXXXXXX.......X
|X...XX....................XX...XXXXXXXXXXXXXX........XX...................................................XXXXXXXXXXXXX.............X...X.....X......X.....X...X....X...XXXXXXXX....XXXXXXXX...XXXXXXX................XXXXXXXXXXXXXXXXX.....XXXXXXXXXXX........X
|X...XX....................XX...XXXXXXXXXXXXXXXXX......XX...........XXXXXXXXXXXXXX........................XXXXXXXXXXXXXX.............X...XXXXXXX......XXXXXXX...XXXXXX..........................XXXXX....................XXXXXXXXXXXXXXX........................X
|X...XX....................XX...XXXXXXXXXXXXXXXXXXX....XX..........XXXXXXXXXXXXXXXX.......................XXXXXXXXXXXXXX.............X............XX............................................XXXXX........X..............XXXXXXXXXXXX........................X
|X..............................XXXXXXXXXXXXXXXXX....XXXX.........XXXXXXXXXXXXXXXXXX......................XXXXXXXXXXXXX..............X............XX............................................XXXX........XXX..............XXXXXXXXXXXXXXXXXXXX..XXXXXXXXXXXXXX
|X...XX....................XX...XXXXXXXXXXXXXXXX....XXXX...........XXXXXXXXXXXXXXXX.......................XXXXXXXXXXXXX..............X...XXXXXXXXXXXXXXXXXXXXXXXXXXXXX..........................XXX........XXXXX..............XXX.....X.......X......X....X.....X
|X...XX....................XX...XXXXXXXXXXXXXXXXXX.................XX..XX...XXX..XX.......................XXXXXXXXXXXXX..............X............XX.................X..........................XXX..........X.......................XXXX....XXX....XXX..XXX....X
|X...XX....................XX...XXXXXXXXXXXXXXXXXXXX...............XXXXXX...XXXXXXX........................XXXXXXXXXXXX..............X............XX.................X..........................XX....................................X.......X......X....X.....X
+X..............................XXXXXXXXXXXXXXXXXXXXXXX....................................................XXXXXXXXXXXX..............X............XX...........XXXX..XXXXXXXXXXXXXXXXXXXXXXXXXXXXX..............................................................X
|X..............................XXXXXXXXXXXXXXXXXXXXXXX....................................................XXXXXXXXXXXX..............X............XX...........XXXX..XXXXXXXXXXXXXXXXXXXXXXXXXXXXX..............................................................X
|X..............................XXXXXXXXXXXXXXXXXXXXX......................................................XXXXXXXXXXXX..............XXXXXXXXXX...XX.....XXXXXXXXXX..X.........................XXXX......X.....X.....X.....X....................................X
|X...XX....................XX...XXXXXXXXXXXXXXXXXXX.XXXXXXXXXX......XXXXXXX.....XXXXXXXXXXXXX..............XXXXXXXXXXXX..............X............XX...........XXXX..X.........................XXXXX....XXX...XXX...XXX...XXX...................................X
|X...XX....................XX...XXXXXXXXXXXXXXXX...XXXXXXXXXXXX....XXXXXXXXX...XXXXXXXXXXXXXXX.............XXXXXXXXXXXXX.............X............XX...........XXXX..X..XXXXXXXX..XXXXXXXX.....XXXX....XXXXX.XXXXX.XXXXX.XXXXX..........XXX..............XXX....X
|X...XX....................XX...XXXXXXXXXXXXXX....XXXXXXXXXXXXXX..XXXXXXXXXXX.XXXXXXXXXXXXXXXXX............XXXXXXXXXXXXX.............X...XXXXXXXXXXXXXXXXXXX...XXXX..X..XXXXXX......XXXXXX.....XXX.......X.....X.....X.....X...........XXXXX.....X......XXXXX...X
|X.............XXXX.............XXXXXXXXXXXX.......XXXXXXXXXXXX....XXXXXXXXX...XXXXXXXXXXXXXXX.............XXXXXXXXXXXXX.............X...X.................X...XXXX..X..XXXXX........XXXXX.....XXXX....................................XXXXX....XXX.....XXXXX...X
|X...XX.......XXXXXX.......XX...XXXXXXXXXX.........XXX..XX...XX....XX.X...XX...XX..XX...XX..XX.............XXXXXXXXXXXXX.............X.........................XXXX.....XXXXX........XXXXX.....XXXX...X......X......X.....X.............XXX....XXXXX.....XXX....X
|X...XX....................XX...XXXXXXX............XXXXXXX...XX....XXXX...XX...XXXXXX...XXXXXX.............XXXXXXXXXXXX..............XX.....XXXXXXXXXXXXXX....XXXXX.....XXXXX........XXXXX.....XXX...XXX....XXX....XXX...XXX.............X.......X........X.....X
|X...XX....................XX...XXXXXX.....................................................................XXXXXXXXXXXX..............XXXXXXXXX..........XXXXXXXXXXXXXXXXXX..............XXXXXXXXXX..XXXXX..XXXXX..XXXXX.XXXXX............X................X.....X
|X..............................XXX........................................................................XXXXXXXXXXXX........................................................................XXX....X......X......X.....X.....................................X
+X..............................XXX........................................................................XXXXXXXXXXXX........................................................................XXX...............................XXX...........................XX
|X...........XX....XX..........XXXX........................................................................XXXXXXXXXXXX...........................................................................................................XX...........................XX
|X.........XXXX....XXXX........XXXX.............XXX........................................................XXXXXXXXXXXX............XXXXXXXX..XXXXXXXX..XXXXXXXX....XXXXXXXX..XXXXXXXX..XXXXXXXX........XXXXXXXXXXXXXXXXXXX.........XX...X........X.......X....XXX
|X.......XX..XX....XX..XX......XXXX...........XX...XX...............XXXXXXXXXXXXX......XXXXXXX.............XXXXXXXXXXXX............XXXXXXXX..XXXXXXXX..XXXXXXXX....XXXXXXXX..XXXXXXXX..XXXXXXXX......XXX................XXXX.......XX..XXX......XXX.....XXX...XXX
|X.....XX....XX....XX....XX....XXXX.............XXX................XXXXXXXXXXXXXXX....XXXXXXXXX............XXXXXXXXXXXX............XXXXXXXX..XXXXXXXX..XXXXXXXX....XXXXXXXX..XXXXXXXX..XXXXXXXX.....XX.....................XX.......XX..X...X....X.......X.....XX
|X...XX......XX....XX......XX..XXXX...............................XXXXXXXXXXXXXXXXX..XXXXXXXXXXX...................................XXXXXXXX..XXXXXXXX..XXXXXXXX....XXXXXXXX..XXXXXXXX..XXXXXXXX....XX.......................XX.....XX......XXX.................XX
|X.XXXXXXXXXXXX....XXXXXXXXXXXX......XXXXXXXXXXXX....XXXXXXXXXX....XXXXXXXXXXXXXXX....XXXXXXXXX....................................................................................................XX........................XX.....XX......X.......X.........XXX
|X...XX..XX..XX....XX..XX..XX.......XXXXXXXXXXXXXX..XXXXXXXXXXXX...XX..XX...XX..XX....XX.XX...X...........XXXXXXXXXXXXX............XXXXXXXX..XXXXXXXX..XXXXXXXX....XXXXXXXX..XXXXXXXX..XXXXXXXX....XX........................XX....XX.........X....XXX.........XX
|X...XX..XX..XX....XX..XX..XX........XXXXXXXXXXXX....XXXXXXXXXX....XXXXXX...XXXXXX....XXXXX...X...........XXXXXXXXXXXXX............XXXXXXXX..XXXXXXXX..XXXXXXXX....XXXXXXXX..XXXXXXXX..XXXXXXXX....XXX.....................XXXX.....XX...X...XXX....X....X....XXX
|X..XXXXXXXXXXX....XXXXXXXXXXX.......XX.XX...XX.X....XX.XX...XX............................................XXXXXXXXXXXX............XXXXXXXX..XXXXXXXX..XXXXXXXX....XXXXXXXX..XXXXXXXX..XXXXXXXX....X.XXX.................XXX.XX....XX...XXX...X.........XXX...XXX
|X...................................XXXXX...XXXX....XXXXX...XX............................................XXXXXXXXXXXX............XXXXXXXX..XXXXXXXX..XXXXXXXX....XXXXXXXX..XXXXXXXX..XXXXXXXX....X.......XXXXXXXXXXXXXX.XX.XX.....XX...X...............X.....XX
+X.........................................................................................................XXXXXXXXXXXX............................................................................X.......X.XXXXXXXX.XXX.XXXXX....XX...........................X
|X.........................................................................................................XXXXXXXXXXXX............................................................................X.......X.XXX..XXX.XXXXXXXXX....XX...........................X
|XXX..........................................X............................................X...............XXXXXXXXXXXXX.................X.........X...............................................X....XXXXXXXX..XXXXXXX.XXXXX.....XX..X....X.....X.....X......X
|XXXXX.......................................XXX..........................................XXX..............XXXXXXXXXXXXX................XXX.......XXX..............................................X.......XXXXXXXXXX.XXX.XXXXX....XX..XXX..XXX...XXX...XXX....XX
|XXXXXXX....................................XXXXX........................................XXXXX.............XXXXXXXXXXXXXX..............XXXXX.....XXXXX.............................................XXX........XXXXXXX.XXXXXX.XX.....XX..X....X.....X.....X.....XX
|XXXXXXXXXX......XXX..........................X............................................X..............XXXXXXXXXXXXXXX.............XXX.XXX...XXX.XXX...X.........XXX..XXX...XXXX....XXX..XXX....XX.XXX..........XXXXXXXXX.XX....XX.....X.....X.....X.......XXX
|XXXXXXXX.......XXXXX.................X...............................X...................................XXXXXXXXXXXXXXXXX..........XXX...XXX.XXX...XXX.XXX.......X...XX...X.XXXXXX..X...XX...X...XXXXX.XXX..........XXX.XXXXX.....XX...XXX...XXX...XXX......XXX
|XXXXXX.......XXXXXXXXX..............XXX............X................XXX............X...................XXXXXXXXXXXXXXXXXXXXX...........................XXXXX..........XX.....XXXXXX.....XX........XXXXX.XXXXXX..........XXXXXX.....XX....X.....X.....X......XXXX
|XXXXXX........XXXXXX................XXXX..........XXX...............XXXX..........XXX................XXXXXXXXXXXXXXXXXXXXXXXX.........................XXX.XXX..........XX....XX..XX.....XX........XX.XXXXXX.XXXXXXX........XXX....XX...X....X.....X.....X....XXX
|XXXXX...........XXXXXX.............XXXXX.........XXXXX.............XXXXX.........XXXXX............XXXXXXXXXXXXXXXXXXXXXXXXXXXXX......................XXX...XXX.........XX....XX..XX....XX.........XX.XXXXXXXXXX..XXXXX.......X....XX..XXX..XXX...XXX...XXX....XX
|XXX...............XXXXX..............X.............X.................X.............X............XXXXXXXXXXXXXXXXXXXXXXXXXXXXXXXXXX......................................XX.............XX.........XXXXX.XXXXXXXXXXXXXXXXX....X....XX...X....X.....X.....X......X
+X.............................................................................................XXXXXXXXXXXXXXXXXXXXXXXXXXXXXXXXXXXX................................................................XXXXX.XXX.XXXXXXXX.X.....XXX.....XX..........................X
|X.............................................................................................XX.............XXXXXXXXXXXXX......XX................................................................XX.XXXXXX.XXXXXXXXXX.....XXX.....XX..........................X
|X...........X................................................................................XXX...........XXXXXXXXXXXXXXX......XXX...................................XXX..XXX......XXX..XXX......XX.XXXXXXXX...........XXXXXX.................................X
|X......................................XXXXXXXXXXXXXXXXXX..................................XXXXX..........XXXXXXXXXXXXXXXX......XXXX.................................X...XX...X....X...XX...X.....XXXXX.XXXXX........XXX.XXXXX.................................X
|X.....X.....................X.........XXXXXXXXXXXXXXXXXXXX...............................XXXXXXX........XXXXXXXXXXXXXXXXXX......XXXXX....................................XX............XX.........XXXXX.XXX.X.....XXXXXX.XXXXX.................................X
|X....................................XXXXXXXXXXXXXXXXXXXXXX.............................XXXXXXXX......XXXXXXXXXXXXXXXXXXXX......XXXXXXX.................................XX............XX..........XX.XXXXXX.X...XXXX.XXXXXX.XX...........................X.....X
|X.....................................XXXXXXXXXXXXXXXXXXXX............................XXXXXXXXXX.....XXXXXXXXXXXXXXXXXXXXX......XXXXXXXXXXX............................XX............XX...........XX.XXXXXXXX......XXXXXXXX.XX............X.............XXX....X
|X.....................................XXX..XXX...XXXX..XXX...........................XXXXXXXXXXX...............XX...............XXXXXXXXXXXXXX........................XX............XX............XXXXX.XXXXXXX..XXXXXXX.XXXX............XXX.............X.....X
|X...................X.................XXXXXXXX...XXXXXXXXX.........................XXXXXXXXXXXXX....XXXXXXXXXXXXXXXXXXXXXXXXXX..XXXXXXXXXXXXXXXXX..................................................XXXX.XXX.XX....XX.XXX.XXX..............X....................X
|X.................................................................................XXXXXXXXXXXXXX...XX..........XX............XX.XXXXXXXXXXXXXXXXXXXXX...............................................XXXXXXX.XX....XX.XXXXXX........XXXX.........XXXX......XXXXXX
|X..X..............................................................................XXXXXXXXXXXXXX..XXX..........XX............XX.XXXXXXXXXXXXXXXXXXXXXXXXXX............................................XXXXXXXX....XXXXXXX.......XXXXXXXXX...XXXXXXXXXX...XXXXXXX
+X...............X................................................................XXXXXXXXXXXXXXX.XXXX..........XX............XXXXXXXXXXXXXXXXXXXXXXXXXXXXXXXXXXXXX..............................................................XXXXXXXXXXXXXXXXXXXXXXXXXXXXXXXX
|X...............................................................................XXXXXXXXXXXXXXXX.XXXX..XX......XX...XXXXX....XXXXXXXXXXXXXXXXXXXXXXXXXXXXXXXXXXXXX.............................................................XXX.............................X
|X..................................................................................XXXXXXXXXXXXXXXXXX...............X...X....XXXXXXXXXXXXXXXXXXXXXXXXXXXXXXXXXXXXXXXX.........................................................XXXX............................XX
|XXX..................................................................................XXXXXXXXXXX.XXXX........................XXXXXXXXXXXXXXXXXXXXXXXXXXXXXXXXXXXXXXXXXXX......................................................XXXX............................XX
|XXXXXX.................................................................................XXXXXXXXX..XXX......................XXXX.XXXXXXXXXXXXXXXXXXXXXXXXXXXXXXXXXXXXXXXXXXXX................................................XXXXXXX.........................XXXX
|XXXXXXXXX................................................................................XXXXXXX...XXXXXXXXXXXX...XXXXXXXXXXXXX.XXXXXXXXXXXXXXXXXXXXXXXXXXXXXXXXXXXXXXXXXXXXXX...............................................XXXXXX..........................XXX
|XXXXXXXXXXXXXX........................................X....................................XXXXX....XXXXXXXXXXX...XXXXXXXXXXXXX.XX............................XXXXXXXXXXXXXXXXXX............................................XXXXXXX.........................XXXX
|XXXX....XXXXXXXXXX...................................XXX.....................................XXXXXXXXXXXXXXXXXX...XXXXXXXXXXXX..XX............................XXXXXX....XXXXXXXXXX........................................XXXXXXXXXX......................XXXXXX
|XXX......XXXXXXXXXXXX.............................................................................................XX..........................................XXXXX......XXXXXXXXXXXX....................................XXXXXXXXXXX.....................XXXXXXX
|XXX......XXXXXXXXXXXXXXXXX...........XXXX...XXXXXX.......XXXX.....................................................XX..........................................XXXXX......XXXXXXXXXXXXXXXXX.........XXX......XXXXX.......XXXXXXXXXXXXXXX.....XXXXX.......XXXXXXXX
|XXXX....XXXXXXXXXXXXXXXXXXXXXXXXXXXXXXXXXXXXXXXXXXXX...XXXXXXXXXXXXXXXXXXXXXXXXXXXXXXXXXXXXXXXXXXXXXXXXXXXXXXXXXXXXX............XXXXXXXXXXXXXXXXXXXXXXXXXXXXXXXXXXXX....XXXXXXXXXXXXXXXXXXXXXXXXXXXXXXXX..XXXXXXXXXX...XXXXXXXXXXXXXXXXXXXXXXXXXXXXX...XXXXXXXXX
+XXXXXXXXXXXXXXXXXXXXXXXXXXXXXXXXXXXXXXXXXXXXXXXXXXXXXXXXXXXXXXXXXXXXXXXXXXXXXXXXXXXXXXXXXXXXXXXXXXXXXXXXXXXXXXXXXXXX............XXXXXXXXXXXXXXXXXXXXXXXXXXXXXXXXXXXXXXXXXXXXXXXXXXXXXXXXXXXXXXXXXXXXXXXXXXXXXXXXXXXXXXXXXXXXXXXXXXXXXXXXXXXXXXXXXXXXXXXXXXXXXXXX
